P,B,B,B,B,B,B,B
D,B,B,B,B,B,B,B
B,B,B,B,B,E,B,B
B,B,B,A,B,B,B,B
B,B,B,P,B,B,B,B
F,B,P,P,P,P,P,B
P,B,B,P,B,B,B,B
S,P,P,P,B,B,B,B
0,0,0,0,0,0,0,~
P,B,B,B,B,B,B,P
P,P,B,B,B,B,B,B
B,P,B,B,B,P,P,P
E,P,B,B,B,B,B,B
B,P,P,B,B,B,B,B
B,B,B,B,B,B,B,B
B,B,B,B,B,B,F,B
B,B,P,P,C,P,P,B
0,0,0,0,0,0,0,~
P,B,B,P,P,C,P,G
P,B,P,P,B,B,B,P
B,B,B,P,B,B,B,C
B,B,B,P,B,B,P,P
B,B,P,P,B,B,P,B
B,B,B,B,P,P,P,B
B,B,P,B,P,B,B,B
B,B,P,P,P,P,B,B
0,0,0,0,0,0,0,~
P,B,B,P,P,C,P,G
P,B,P,P,B,B,B,P
B,B,B,P,B,B,B,C
B,B,B,P,B,B,P,P
B,B,P,P,B,B,P,B
B,B,B,B,P,P,P,B
B,B,P,B,P,B,B,B
B,B,P,P,P,P,B,B
0,0,0,0,0,0,0,~
P,B,B,P,P,C,P,G
P,B,P,P,B,B,B,P
B,B,B,P,B,B,B,C
B,B,B,P,B,B,P,P
B,B,P,P,B,B,P,B
B,B,B,B,P,P,P,B
B,B,P,B,P,B,B,B
B,B,P,P,P,P,B,B
0,0,0,0,0,0,0,~
P,B,B,P,P,C,P,G
P,B,P,P,B,B,B,P
B,B,B,P,B,B,B,C
B,B,B,P,B,B,P,P
B,B,P,P,B,B,P,B
B,B,B,B,P,P,P,B
B,B,P,B,P,B,B,B
B,B,P,P,P,P,B,B
0,0,0,0,0,0,0,~
P,B,B,P,P,C,P,G
P,B,P,P,B,B,B,P
B,B,B,P,B,B,B,C
B,B,B,P,B,B,P,P
B,B,P,P,B,B,P,B
B,B,B,B,P,P,P,B
B,B,P,B,P,B,B,B
B,B,P,P,P,P,B,B
0,0,0,0,0,0,0,~
P,B,B,P,P,C,P,G
P,B,P,P,B,B,B,P
B,B,B,P,B,B,B,C
B,B,B,P,B,B,P,P
B,B,P,P,B,B,P,B
B,B,B,B,P,P,P,B
B,B,P,B,P,B,B,B
B,B,P,P,P,P,B,B
0,0,0,0,0,0,0,*